# Dateien im OpenXP Verzeichnis
#
# $Id$
#
Makefile	Makefile fuer GNU make
ObjCOM/Makefile	Makefile fuer GNU make
ObjCOM/developer.txt	???
ObjCOM/example.pas	???
ObjCOM/license.txt	???
ObjCOM/objcom.pas	???
ObjCOM/ocdeffpc.inc	???
ObjCOM/ocdefine.inc	???
ObjCOM/ocfdos.inc	???
ObjCOM/ocfdosh.inc	???
ObjCOM/ocsdos.inc	???
ObjCOM/ocsdosh.inc	???
ObjCOM/ocslin.inc	???
ObjCOM/ocslinh.inc	???
ObjCOM/ocsos2.inc	???
ObjCOM/ocsos2h.inc	???
ObjCOM/ocswin.inc	???
ObjCOM/ocswinh.inc	???
ObjCOM/octhread.pas	???
ObjCOM/octwin.inc	???
ObjCOM/octwinh.inc	???
ObjCOM/ringbuff.pas	???
ObjCOM/serial.pas	???
ObjCOM/todo.txt	???
archive.pas	Verzeichnis von Archivdateien auslesen (ZIP, ARJ, etc.)
beispiel/glossary.cfg	Beispieldatei fuer Glossary-Funktion (Editor)
beispiel/gsbox.scr	Login-Script fuer GSMail
beispiel/madness.scr	Login-Script fuer Madness-Boxen
beispiel/magic.scr	Login-Script fuer MagicNET
beispiel/maus.scr	Login-Script fuer MAUS-Boxen
beispiel/o-magic.scr	Login-Script fuer MagicNET (Online)
beispiel/oz-netz.scr	Login-Script fuer Z-Netz (Online)
beispiel/pcsysop.scr	Login-Script fuer NetLand und PCNet
beispiel/privhead.xps	Schablone fuer nicht zitierte Mails
beispiel/qbrett.xps	Schablone fuer zitierte, oeff. Nachricht
beispiel/qpmpriv.xps	Schablone fuer zitierte Mails
beispiel/qpriv.xps	Schablone fuer als Mail zit. oeff. Nachrichten
beispiel/quark.scr	Login-Script fuer QUARK-Boxen
beispiel/quoteto.xps	Schablone fuer /Nachr./Weiterl./QuoteTo
beispiel/uucp.scr	Login-Script fuer UUCP
beispiel/xpmailto.reg	???
beispiel/z-netz.scr	Login-Script fuer Z-Netz
build.bat	DOS-Batchdatei zum Compilieren von OpenXP
charsets/8859_1.inc	???
charsets/8859_10.inc	???
charsets/8859_13.inc	???
charsets/8859_14.inc	???
charsets/8859_15.inc	???
charsets/8859_2.inc	???
charsets/8859_3.inc	???
charsets/8859_4.inc	???
charsets/8859_5.inc	???
charsets/8859_6.inc	???
charsets/8859_7.inc	???
charsets/8859_8.inc	???
charsets/8859_9.inc	???
charsets/cp1251.inc	???
charsets/cp1252.inc	???
charsets/cp1255.inc	???
charsets/cp437.inc	???
charsets/cp866.inc	???
clip.pas	Schnittstelle zum 16-Bit-Windows-Clipboard via INT 2F
crc.pas	CRC16/32-Routinen
databas1.inc	Datenbankfunktionen fuer *.DB1/*.IX1/*.EB1
databas2.inc	Datenbankfunktionen fuer *.DB1/*.IX1/*.EB1
database.inc	Datenbankfunktionen fuer *.DB1/*.IX1/*.EB1
database.pas	Datenbankfunktionen fuer *.DB1/*.IX1/*.EB1
databaso.pas	Datenbankfunktionen fuer *.DB1/*.IX1/*.EB1
datadef.pas	Datenbankfunktionen fuer *.DB1/*.IX1/*.EB1
datadef1.pas	Datenbankfunktionen fuer *.DB1/*.IX1/*.EB1
dbase.pas	dBASE-Dateien auslesen (fuer YUP2PKT)
debug.pas	Debug-Unit. Per Environment steuerbare Logmessages.
doc/Makefile	Makefile fuer GNU make
doc/authors.txt	Namen und E-Mail-Adressen der OpenXP-Autoren
doc/dbform.txt	Beschreibung der Datenbankfelder
doc/devtodo.txt	zu erledigende Aufgaben
doc/fido.dq	Fido-Dokumentation im Quelltext
doc/files.txt	Liste der Dateien im OpenXP-Quellcode (diese Datei)
doc/gpl.txt	GNU General Public License
doc/linux.txt	Hinweise zur Nutzung unter Linux
doc/make.txt	Anleitung zum Compilieren von OpenXP
doc/planung.txt	Strategieplanung fuer die weiteren OpenXP-Versionen
doc/readme.txt	wichtige Hinweise
doc/slizenz.txt	Lizenz des OpenXP-Quellcode
doc/tools.txt	Tabelle von externen XP-Tools
doc/update.txt	Hinweise fuer OpenXP-Updates
doc/uucp.dq	UUCP-Dokumentation im Quelltext
doc/versions.txt	Versions-FAQ fuer CrossPoint und OpenXP
doc/xp-e.ihq	Quelltext der englischen Online-Hilfe
doc/xp.ihq	Quelltext der deutschen Online-Hilfe
doc/xpoint.cat	Katalogdatei fuer Handbuch
doc/xpoint.dsl	Stylesheet fuer Handbuch
doc/xpoint.sgm	Handbuch im DocBook-Format
docform.pas	Quelltext zu DOCFORM.EXE
eddef.pas	Editor
editor.inc	Editor
editor.pas	Editor
encoder.pas	???
exxec.pas	externe Programme aufrufen; Swapping
feiertag.pas	Feiertage ermitteln
file_id.diz	???
fileio.inc	???
fileio.pas	Dateien, Pfade, Laufwerke
gpltools.pas	???
help.pas	Online-Hilfe: *.HLP auslesen und anzeigen
icons.res	Icons fuer OpenXP im Windows-Format
ihs.pas	Quelltext zu IHS.EXE (Helpfile-Compiler)
inout.pas	Diverse Funktionen fuer Tastatureingabe und Bildschirmausgabe
ipaddr.pas	Klasse TIP zur Verwaltung einer IP-Adresse (GPL)
ipcclass.pas	Klasse TIPC (Inter Process Communication) (GPL)
keys.pas	Tastatureingabe
linux/fileio.inc	???
linux/fileioh1.inc	???
lister.pas	Lister
maggi.pas	Multiformat-Konvertierer (MAGGI.EXE)
maske.inc	Dialoge / Eingabemasken
maske.pas	Dialoge / Eingabemasken
maus2.pas	Auswertung von Mauseingaben
modem.pas	Modemroutinen
montage.pas	Datumsfunktionen
mouse.pas	Auswertung von Maus-Interrupts (INT 33)
ncnntp.pas	???
ncpop3.pas	???
ncsmtp.pas	???
ncsocket.pas	???
ncurses.pas	???
ndiff.pas	Nodelist-Differ (NDIFF.EXE)
netcall.pas	Abstrakte Klasse TNetcall (GPL)
pmconv.pas	PM-Puffer-Konvertierer (PMCONV.EXE)
printerx.pas	Druckerausgabe
rc.pas	Quelltext zu RC.EXE (Resourcen-Compiler)
regexpr.pas	???
resource.pas	String-Resourcen: *.RES auslesen
stack.pas	ein primitiver Stack
timer.pas	Timer-Routinen
typeform.pas	Typumwandlungen, Stringformatierungen etc.
uart.pas	Ein-/Ausgabe via serieller Schnittstelle oder FOSSIL
unicode.pas	???
utftools.pas	???
uucico.pas	???
uucp-fl1.pas	Beispiel fuer UUCP-Filelisten-Konvertierer
uucp-g.inc	???
uuz.pas	UUCP/RFC-Konvertierer
uuzext.pas	externer UUCP/RFC-Konvertierer
win2.pas	Auswahlfenster
winxp.pas	???
xp-d.rq	deutsches Sprachmodul fuer XP
xp-e.rq	englisches Sprachmodul fuer XP
xp-fm.inc	Fido-Mailer (XP-FM.EXE)
xp-fm.pas	Fido-Mailer (XP-FM.EXE)
xp.pas	CrossPoint-Hauptprogramm, Real-Mode-Version
xp0.pas	globale Definitionen und Deklarationen
xp1.pas	alles Moegliche
xp10.inc	Timinglisten, Tastenmakros, Gebuehrenzonen etc.
xp10.pas	Timinglisten, Tastenmakros, Gebuehrenzonen etc.
xp10p.inc	Timinglisten, Tastenmakros, Gebuehrenzonen etc.
xp1cm.inc	ein ueberfluessiges Relikt
xp1help.pas	Online-Hilfe aufrufen
xp1input.pas	diverse Eingaberoutinen
xp1menu.inc	Menuefunktionen
xp1o.pas	Diverses: Lister-Tastenabfrage
xp1o2.pas	Diverses
xp1s.inc	externe Programme aufrufen
xp2.pas	Initialisierungen bei Programmstart
xp2c.pas	Konfiguration aendern /XPoint/Config
xp2cfg.inc	Konfiguration laden
xp2db.pas	Initialisierungen bei Programmstart
xp2f.pas	Fressen, Ficken, Fernsehen
xp3.pas	diverse Funktionen fuer Pointdatenverwaltung
xp3ex.pas	Nachrichten extrahieren
xp3o.inc	Puffer einlesen
xp3o.pas	diverse Funktionen fuer Nachrichtenverwaltung 
xp3o2.pas	diverse Funktionen fuer Nachrichtenverwaltung 
xp4.inc	Hauptmenueabfrage
xp4.pas	Tastaturabfragen,N/B/U-Fenster
xp4d.inc	Zeilenanzeigeroutine fuer N/B/U-Fenster
xp4e.pas	Editierfunktionen fuer N/B/U-Fenster
xp4o.inc	Reorganisation
xp4o.pas	Suchfunktionen, Dupekill
xp4o2.pas	DB-Packen, Kommentarbaum
xp4o3.pas	diverse Hilfsfunktionen fuer XP4
xp4w.inc	Auswahl und Aufruf von Lister bzw. externem Viewer
xp5.pas	Kalender, Screen Saver, Passwort u.a.
xp6.pas	Hauptroutine Nachrichten verschicken
xp6l.pas	Nachrichten verschicken (... in DB und Puffer schreiben)
xp6o.pas	Nachrichten verschicken (... in DB und Puffer schreiben)
xp6s.inc	Nachrichten verschicken (... in DB und Puffer schreiben)
xp7.inc	Netcall-Funktionen
xp7.pas	Netcall-Funktionen
xp7f.pas	Netcall-Funktionen
xp7l.pas	Netcall-Funktionen
xp7o.pas	Netcall-Funktionen
xp7u.inc	Netcall-Funktionen
xp8.inc	Brettmanager-Funktionen
xp8.pas	Brettmanager-Funktionen
xp8fs.inc	Brettmanager-Funktionen
xp9.inc	(fast) alle Funktionen im Edit-Menue
xp9.pas	(fast) alle Funktionen im Edit-Menue
xp9bp.pas	(fast) alle Funktionen im Edit-Menue
xp_des.pas	DES-Verschluesselung
xp_iti.pas	MausTausch-ITI-File auswerten
xp_pgp.pas	PGP-Schnittstelle
xp_uue.pas	UUDecode
xpauto.pas	AutoVersandt, Autoexec-Verzeichnis
xpcc.pas	Verteiler
xpcfg.pas	3. Cfg-Datei
xpcurses.pas	XP-spezifisches Interface zur Ansteuerung der Curses-Lib (wird nur unter Unix-Derivaten benoetigt)
xpdatum.pas	Datumsumwandlungen
xpdefine.inc	???
xpdiff.pas	Definitionen fuer XP, XP-FM und ZFIDO
xpdos32.pas	???
xpe.pas	Aufruf des internen Editors
xpeasy.pas	Einfache Erstkonfiguration
xpf1.inc	Fido-Funktionen
xpf2.pas	Fido-Funktionen
xpfido.pas	Fido-Funktionen
xpfidonl.pas	Fido-Nodelisten-Funktionen
xpfiles.inc	Dateinamenskonvertierung fuer UUZ
xpfm-d.rq	deutsches Sprachmodul fuer Fido-Mailer
xpfm-e.rq	englisches Sprachmodul fuer Fido-Mailer
xpftnadr.pas	???
xpglobal.pas	???
xpheader.inc	???
xpimpexp.pas	Import/Export-Funktionen
xpipc.pas	???
xpkeys.pas	Funktionstasten und Makros
xplinux.pas	XP-spezifisches Interface unter Linux
xpmakehd.inc	ZCONNECT- und Z3.8-Header parsen
xpmaus.pas	MausTausch-Funktionen
xpme.pas	Menueeditor (XPME.EXE)
xpmecol.inc	Menueeditor (XPME.EXE)
xpmime.pas	nur XP 3.2: MIME-Viewer-Funktionen
xpnntp.pas	???
xpnodes.pas	Unit fuer Zugriff auf den XP-Nodelistenindex
xpnt.pas	Netztypen
xpos2.pas	???
xpreg.pas	/XPoint/Registrierung
xpstat.pas	/XPoint/Statistik
xpterm.pas	/XPoint/Terminal
xpuu-d.rq	deutsches Sprachmodul fuer UUCICO
xpuu-e.rq	englisches Sprachmodul fuer UUCICO
xpuu.pas	UUCICO-Aufruf
xpview.pas	Binaerfile-Viewer
xpwin32.pas	???
xpx.pas	erste Unit: Startup-Funktionen
yup2pkt.pas	???
zfido.pas	FTSC-Konvertierer (ZFIDO.EXE)
zmodem.pas	ZModem-Unit
zpr.pas	ZCONNECT-Pufferreparierer (ZPR.EXE)
